###
#.#
#b#
#p#
###

########
#---#--#
#-#-#b.#
#----b.#
#-#-#b.#
#---#--#
#####p-#
----####

